floor0|0:
0,0,0 0,0,0 0,7,0 0,65543,0 0,65543,0 0,65543,0 0,65543,0 0,65543,0 0,65543,0 0,65543,0 0,65543,0 0,65543,0 0,65543,0 0,262152,0 0,65544,0 0,65544,0 
0,0,0 0,0,0 0,8,0 0,65544,0 0,65544,0 0,65544,0 0,65544,0 0,65544,0 0,65544,0 0,65544,0 0,65544,0 0,65544,0 0,65544,0 0,65544,0 0,65544,0 0,65544,0 
0,0,0 0,0,0 0,9,0 0,65545,0 0,65545,0 0,65545,0 0,65545,0 0,65545,0 0,65545,0 0,65545,0 0,65545,0 0,65545,0 0,65545,0 0,262151,0 0,65544,0 0,65544,0 
0,0,0 0,0,0 0,0,0 0,0,0 0,0,0 0,0,0 0,0,0 0,0,0 0,0,0 0,0,0 0,0,0 0,0,0 0,0,0 0,9,0 0,65545,0 0,65545,0 
0,0,0 0,0,0 0,0,0 0,0,0 0,0,0 0,0,0 0,0,0 0,0,0 0,0,0 0,0,0 0,0,0 0,0,0 0,0,0 0,0,0 0,0,0 0,0,0 
0,0,0 0,0,0 0,0,0 0,0,0 0,0,0 0,0,0 0,0,0 0,0,0 0,0,0 0,0,0 0,0,0 0,0,0 0,0,0 0,0,0 0,0,0 0,0,0 
0,0,0 0,0,0 0,0,0 0,0,0 0,0,0 0,0,0 0,0,0 0,0,0 0,0,0 0,0,0 0,0,0 0,0,0 0,0,0 0,0,0 0,0,0 0,0,0 
0,0,0 0,0,0 0,0,0 0,0,0 0,0,0 0,0,0 0,0,0 0,0,0 0,0,0 0,0,0 0,0,0 0,0,0 0,0,0 0,0,0 0,0,0 0,0,0 
0,0,0 0,0,0 0,0,0 0,0,0 0,0,0 0,0,0 0,0,0 0,0,0 0,0,0 0,0,0 0,0,0 0,0,0 0,0,0 0,0,0 0,0,0 0,0,0 
0,0,0 0,0,0 0,0,0 0,0,0 0,0,0 0,0,0 0,0,0 0,0,0 0,0,0 0,0,0 0,0,0 0,0,0 0,0,0 0,0,0 0,0,0 0,0,0 
0,0,0 0,0,0 0,0,0 0,0,0 0,0,0 0,0,0 0,0,0 0,0,0 0,0,0 0,0,0 0,0,0 0,0,0 0,0,0 0,0,0 0,0,0 0,0,0 
0,0,0 0,0,0 0,0,0 0,0,0 0,0,0 0,0,0 0,0,0 0,0,0 0,0,0 0,0,0 0,0,0 0,0,0 0,0,0 0,0,0 0,0,0 0,0,0 
0,0,0 0,0,0 0,0,0 0,0,0 0,0,0 0,0,0 0,0,0 0,1,0 0,65537,0 0,65540,0 0,65537,0 0,131073,0 0,0,0 0,0,0 0,0,0 0,0,0 
0,0,0 0,0,0 0,0,0 0,0,0 0,0,0 0,0,0 0,1,0 0,262146,0 0,65538,0 0,65541,0 0,65538,0 0,196610,0 0,0,0 0,0,0 0,0,0 0,0,0 
0,0,0 0,0,0 0,0,0 0,0,0 0,0,0 0,0,0 0,2,0 0,65538,0 0,65541,0 0,65538,0 0,65538,0 0,65538,0 0,131074,0 0,0,0 0,0,0 0,0,0 
0,0,0 0,0,0 0,0,0 0,0,0 0,0,0 0,0,0 0,3,0 0,262145,0 0,65538,0 0,65538,0 0,196609,0 0,65539,0 0,131075,0 0,0,0 0,4,0 0,262149,0 
walls1|1:
-1 -1 -1 -1 -1 -1 -1 -1 -1 -1 -1 -1 -1 -1 -1 -1 
-1 -1 -1 -1 -1 -1 -1 -1 -1 -1 -1 -1 -1 -1 -1 -1 
-1 -1 -1 -1 -1 -1 -1 -1 -1 -1 1,0,0 -1 1,0,0 -1 -1 -1 
-1 -1 -1 -1 -1 -1 1,0,0 1,0,0 -1 1,0,0 -1 1,0,0 -1 -1 -1 1,0,0 
-1 -1 -1 -1 -1 -1 -1 -1 1,0,0 -1 -1 -1 -1 -1 -1 -1 
2,65536,0 2,131072,0 -1 -1 2,65536,0 2,131072,0 -1 -1 -1 -1 -1 -1 -1 -1 -1 2,65536,0 
2,65537,0 2,131073,0 2,0,0 2,0,0 2,65537,0 2,131073,0 2,0,0 2,0,0 2,0,0 2,0,0 2,0,0 2,0,0 2,0,0 2,0,0 2,0,0 2,65537,0 
2,65538,0 2,131074,0 2,1,0 2,1,0 2,65538,0 2,131074,0 2,1,0 2,1,0 2,1,0 2,1,0 2,1,0 2,1,0 2,1,0 2,1,0 2,1,0 2,65538,0 
2,65539,0 2,131075,0 2,2,0 2,2,0 2,65539,0 2,131075,0 2,2,0 2,2,0 2,2,0 2,2,0 2,2,0 2,2,0 2,2,0 2,2,0 2,2,0 2,65539,0 
2,65540,0 2,131076,0 2,3,0 2,3,0 2,65540,0 2,131076,0 2,3,0 2,3,0 2,3,0 2,3,0 2,3,0 2,3,0 2,3,0 2,3,0 2,3,0 2,65540,0 
2,65541,0 2,131077,0 -1 -1 2,65541,0 2,131077,0 -1 -1 -1 -1 -1 -1 -1 -1 -1 2,65541,0 
-1 -1 -1 -1 -1 -1 -1 -1 -1 -1 -1 -1 -1 -1 -1 -1 
2,196611,0 2,262147,0 -1 -1 -1 -1 -1 -1 -1 -1 -1 -1 -1 -1 -1 -1 
2,196611,0 2,262147,0 1,0,0 -1 -1 -1 -1 -1 -1 -1 -1 -1 -1 -1 -1 -1 
2,196611,0 2,262147,0 -1 -1 -1 -1 -1 -1 -1 -1 -1 -1 -1 -1 -1 -1 
2,196611,0 2,262147,0 -1 -1 -1 -1 -1 -1 -1 -1 -1 -1 -1 -1 -1 -1 
walls2|2:
-1 -1 -1 -1 -1 -1 -1 -1 -1 -1 -1 -1 -1 -1 -1 -1 
-1 -1 -1 -1 -1 -1 -1 -1 -1 -1 -1 -1 -1 -1 -1 -1 
-1 -1 -1 -1 -1 -1 -1 -1 -1 -1 -1 -1 -1 -1 -1 -1 
-1 -1 -1 -1 -1 -1 -1 -1 -1 -1 -1 -1 -1 -1 -1 -1 
-1 -1 -1 -1 -1 -1 -1 -1 -1 -1 -1 -1 -1 -1 -1 -1 
-1 -1 -1 -1 -1 -1 -1 -1 -1 -1 -1 -1 -1 -1 -1 -1 
-1 -1 -1 -1 -1 -1 -1 -1 -1 -1 -1 -1 -1 -1 -1 -1 
-1 -1 -1 -1 -1 -1 -1 -1 -1 -1 -1 -1 -1 -1 -1 -1 
-1 -1 -1 -1 -1 -1 -1 -1 -1 -1 -1 -1 -1 -1 -1 -1 
-1 -1 -1 -1 -1 -1 -1 -1 -1 -1 -1 -1 -1 -1 -1 -1 
-1 -1 -1 -1 -1 -1 -1 -1 -1 -1 -1 -1 -1 -1 -1 -1 
-1 -1 -1 -1 -1 -1 -1 -1 -1 -1 -1 -1 -1 -1 -1 -1 
-1 -1 -1 -1 -1 -1 -1 -1 -1 -1 -1 -1 -1 -1 -1 -1 
-1 -1 -1 -1 -1 -1 -1 -1 -1 -1 -1 -1 -1 -1 -1 -1 
-1 -1 -1 -1 -1 -1 -1 -1 -1 -1 -1 -1 -1 -1 -1 -1 
-1 -1 -1 -1 -1 -1 -1 -1 -1 -1 -1 -1 -1 -1 -1 -1 
decorations|3:
-1 -1 -1 -1 -1 -1 -1 -1 -1 1,262146,0 -1 -1 -1 -1 -1 -1 
-1 -1 -1 -1 -1 -1 -1 -1 -1 -1 -1 -1 -1 -1 -1 -1 
-1 -1 -1 -1 -1 -1 -1 -1 -1 -1 -1 -1 -1 -1 -1 -1 
-1 -1 -1 -1 1,393216,0 -1 -1 -1 -1 -1 -1 -1 -1 -1 -1 -1 
-1 -1 -1 1,262146,0 1,262146,0 -1 -1 -1 -1 -1 -1 -1 -1 -1 -1 -1 
-1 -1 -1 1,262146,0 -1 -1 -1 -1 -1 -1 -1 -1 -1 1,393217,0 -1 -1 
-1 -1 -1 -1 -1 -1 -1 -1 -1 -1 -1 -1 -1 -1 -1 -1 
-1 -1 -1 -1 -1 -1 -1 -1 -1 -1 -1 -1 -1 -1 -1 -1 
-1 -1 -1 -1 -1 -1 -1 -1 -1 -1 -1 -1 -1 -1 -1 -1 
-1 -1 -1 -1 -1 -1 -1 -1 -1 -1 -1 -1 -1 -1 -1 -1 
-1 -1 -1 -1 -1 -1 -1 -1 -1 -1 -1 -1 -1 -1 -1 -1 
-1 -1 -1 -1 -1 -1 -1 -1 -1 -1 -1 -1 -1 -1 -1 -1 
-1 -1 -1 -1 -1 -1 -1 -1 -1 -1 -1 -1 -1 -1 -1 -1 
-1 -1 -1 -1 -1 -1 -1 -1 -1 -1 -1 -1 -1 -1 -1 -1 
-1 -1 -1 -1 -1 -1 -1 -1 -1 -1 -1 -1 -1 -1 -1 -1 
-1 -1 -1 -1 -1 -1 -1 -1 -1 -1 1,262144,0 1,262144,0 -1 -1 -1 -1 
overhead1|4:
-1 -1 -1 -1 -1 -1 -1 -1 -1 -1 -1 1,2,0 -1 -1 -1 -1 
-1 -1 -1 -1 -1 -1 -1 -1 -1 -1 -1 -1 -1 -1 -1 -1 
-1 -1 -1 -1 -1 -1 -1 -1 -1 -1 -1 -1 -1 -1 -1 -1 
-1 -1 -1 -1 -1 -1 -1 -1 -1 -1 1,1,0 -1 1,1,0 -1 -1 -1 
-1 -1 -1 -1 -1 -1 1,1,0 1,1,0 -1 1,1,0 1,65537,0 1,1,0 1,65537,0 -1 -1 1,1,0 
-1 -1 -1 -1 -1 -1 1,131072,0 1,2,0 1,1,0 1,65537,0 1,65538,0 1,65537,0 1,65538,0 -1 -1 1,65537,0 
-1 -1 -1 -1 -1 -1 1,131073,0 -1 1,2,0 1,65537,0 -1 1,65538,0 -1 -1 -1 1,65538,0 
-1 -1 -1 -1 -1 -1 1,131074,0 -1 -1 1,65538,0 -1 -1 -1 -1 -1 -1 
-1 -1 -1 -1 -1 -1 -1 -1 -1 -1 -1 -1 -1 -1 -1 -1 
-1 -1 -1 -1 -1 -1 -1 -1 -1 -1 -1 -1 -1 -1 -1 -1 
-1 -1 2,4,0 2,4,0 -1 -1 2,4,0 2,4,0 2,4,0 2,4,0 2,4,0 2,4,0 2,4,0 2,4,0 2,4,0 -1 
2,65542,0 2,131078,0 -1 -1 2,65542,0 2,131078,0 -1 -1 -1 -1 -1 -1 -1 -1 -1 2,65542,0 
2,65543,0 2,131079,0 -1 -1 2,65543,0 2,131079,0 -1 -1 -1 -1 -1 -1 -1 -1 -1 2,65543,0 
-1 -1 -1 -1 -1 -1 -1 -1 -1 -1 -1 -1 -1 -1 -1 -1 
-1 -1 1,1,0 -1 -1 -1 -1 -1 -1 -1 -1 -1 -1 -1 -1 -1 
-1 -1 1,2,0 -1 -1 -1 -1 -1 -1 -1 -1 -1 -1 -1 -1 -1 
overhead2|5:
-1 -1 -1 -1 -1 -1 -1 -1 -1 -1 -1 -1 -1 -1 -1 -1 
-1 -1 -1 -1 -1 -1 -1 -1 -1 -1 -1 -1 -1 -1 -1 -1 
-1 -1 -1 -1 -1 -1 -1 -1 -1 -1 -1 -1 -1 -1 -1 -1 
-1 -1 -1 -1 -1 -1 -1 -1 -1 -1 -1 -1 -1 -1 -1 -1 
-1 -1 -1 -1 -1 -1 -1 -1 -1 -1 -1 -1 -1 -1 -1 -1 
-1 -1 -1 -1 -1 -1 -1 -1 -1 -1 -1 -1 -1 -1 -1 -1 
-1 -1 -1 -1 -1 -1 -1 -1 -1 -1 -1 -1 -1 -1 -1 -1 
-1 -1 -1 -1 -1 -1 -1 -1 -1 -1 -1 -1 -1 -1 -1 -1 
-1 -1 -1 -1 -1 -1 -1 -1 -1 -1 -1 -1 -1 -1 -1 -1 
-1 -1 -1 -1 -1 -1 -1 -1 -1 -1 -1 -1 -1 -1 -1 -1 
-1 -1 -1 -1 -1 -1 -1 -1 -1 -1 -1 -1 -1 -1 -1 -1 
-1 -1 -1 -1 -1 -1 -1 -1 -1 -1 -1 -1 -1 -1 -1 -1 
-1 -1 -1 -1 -1 -1 -1 -1 -1 -1 -1 -1 -1 -1 -1 -1 
-1 -1 -1 -1 -1 -1 -1 -1 -1 -1 -1 -1 -1 -1 -1 -1 
-1 -1 -1 -1 -1 -1 -1 -1 -1 -1 -1 -1 -1 -1 -1 -1 
-1 -1 -1 -1 -1 -1 -1 -1 -1 -1 -1 -1 -1 -1 -1 -1 
collision:
0000000000000000
0000000000000000
0000000000101000
0000101101110001
0000000011010001
1100001001000001
1111111111111111
1111111111111111
1111111111111111
1111111111111111
1100110000000001
1100000000000000
1100000000000000
1110000000000000
1100000000000000
1100000000000000
